000000000
000030000
000333000
033333330
003333300
000333000
003303300
