1.1.1.1.1
333333333
000000000
222222222
000000000
111111111
000000000
