000000000
044444440
04.....40
044444440
04.....40
044444440
000000000
