000000000
022203330
000200030
002003330
020000030
022203330
000000000
